NO ./textures/Wall1.xpm
SO ./textures/Wall2.xpm
WE ./textures/Wall3.xpm
EA ./textures/Wall4.xpm

F 50,50,50
C 100,100,150

111111
1....1
1....1
1.N..1
1....1
1....1
111111
