NO ./textures/fun1.xpm
SO ./textures/fun2.xpm
WE ./textures/fun3.xpm
EA ./textures/fun4.xpm

F 0,0,0
C 255,255,255

111111111111111111111111111111111111111111111111111111111111111111111111111111111111111111111111111111111111111111111111111111111
101010101010101010110101010101010101010101010110101010101010101010101001010110101010101010101010101010101010101010101010101010101
100000000000000000000000000000000000000000000000000000000000000000000000000000000000000000000000000000000000000000000000000000001
110000000000000000000000000000000000000000000000010000000000000000000000000001000000000000000000000000000000000000000000000000011
100000000000000000000000000000000000000000000000000000100000000000000000010000001000000100000000000000000000000000000000000000001
110000000000000000000000000000000000000000000000000000000010000010000010000000000001000000000000000000000000000000000000000000011
100000000000000000000000000000000000000000000000000000000000000000000000000000000000000000010000000000000000000000000000000000001
110111111111111111111111111111111111111111111111111111111111111111111111111111111111111000000000000000000000000000000000000000011
100000000000000000000000000000000000000000000000000000000000000000000000000000000000001000000000000000000000000000000000000000001
110111111000111011101101010101100110111101010101111111111111111111011011111111111111101000000000000000000000000000000000000000011
100000000101000000000000000000100010100001010101000111111111111111011100000000000000101000010000000000000000000000000000000000001
110000000000000000000000000000100010100001000100101000100000000101000101111111111110101000000000000100000001111111111000000000011
100000000000000000000000000000100010100001011110101010001111101111110101000000000010101000000000000000010001000000001000000000001
110000000000000000000000000000100010100001001100101010111000000000000101111111111010101000000000000000000001000000001000000000011
100000000000000000000000000000100010100001100101101011100110111111110100000000000010001000000000000000100001000000001000000000001
110000000000000000000000000000100010100001001100101000101110100000010111111111111011111000000000000000000001000000001000000000011
10000000000000000000000000000010001010000110011010111010000N001111010100000000000000000000000000100000000001000000001000000000001
110000000000000000000000000000100010100001010100001000001010101000100100000000000000000000000000000000000001000000001000000000011
100000000000000000000000000000100010101111000011101011110010100010001000000000000000000000000011000000000001000000001000000000001
110000000000000000000000000000100010100001111100001000000000011111110000000000000000000000000000000000111111000000001000000000011
100000000000000000000000000000100010011100000001100111111111100000000000000000000001000000000000000000100000000000001000000000001
110000000000000000000000000000100010000011111110011000000000000000000000000000000000000000000010000000100000000000001000000000011
100000000000000000000000000000100011001000000011010000000000000000000000000000000000000000000000000000100000000000001000000000001
110000000000000000000000000000100010100010101011010000000000000000000000000000000000000000000000000000100000000000001000000000011
100000000000000000000000000000100110010000000000000000000000000000000000000000000000000000000000000000100000000000001000000000001
110000000000000000000000000000101000001001011110000000000000000000000000000000000000000000000001000000100000000000001000000000011
100000000000000000000000000000101011100100010000000000000000000000000000000000000001000000000000000000100000000000001000000000001
110000000000000000000000000000101010110101110000000000000000000000000000000000000000000000000000000000100000000000001000000000011
100000000000000000000000000000101010000001000000000000000000000000000000000000000000000000000000000000111111111111111000000000001
110000000000000000000000000000101001111110000000000000000000000000000000000000000000000000000000000000000000000000000000000000011
100000000000000000000000000000101101000000000000000000000000000000000000000000000010000000000000000000000000000000000000000000001
110000000000000000000000000000000101000000000000000000000000000000000000000000000000000000000000000000000000000000000000000000011
100000000000000000000000000000000101000000000000000000000000000000000000000000000000000000000010000000000000000000000000000000001
110000000000000000000000000000000101000000000000000000000000000000000000000000000000000000000000000000000000000000000000000000011
100000000000000000000000000000000101000000000000000000000000000000000000000000000000000000000000000000000000000000000000000000001
110000000000000000000000000000000101100000000000000000000000000000000000000000000000000000000000000000000000000000000000000000011
100000000000000000000000000000000000000000000000000000000000000000000000000000000000000000000000000000000000000000000000000000001
101010101010101010110101010101010101010101010110101010101010101010101001010110101010101010101010101010101010101010101010101010101
111111111111111111111111111111111111111111111111111111111111111111111111111111111111111111111111111111111111111111111111111111111
