NO ./textures/Wall1.xpm
SO ./textures/Wall2.xpm
WE ./textures/Wall3.xpm
EA ./textures/Wall4.xpm

F 128,128,128
C 230,230,230

        1111111111111111111111111
        1000000000110000000000001
        1011000001110000000000001
        1001000000000000000000001
111111111011000001110000000000001
100000000011000001110111111111111
11110111111111011100000010001
11110111111111011101010010001
110000001101010111000000100011111111111111111111111111111111
100000000000000011000000100000000000000000000000000000000001
100000000000000011010100100011111111111111111111111111111101
1100000111010101111101111000111                     1000E101
11110111 1110101 101111010001                       10111101
11111111 1111111 111111111111                       10000001
                                                    11111111
