NO ./textures/a.xpm
SO ./textures/b.xpm
WE ./textures/c.xpm
EA ./textures/d.xpm

F 0,0,0
C 150,150,150

11111
1N001
11111
