NO ./textures/Wall.xpm
SO ./textures/Wall.xpm
WE ./textures/Wall.xpm
EA ./textures/Wall.xpm

F 40,40,40
C 140,140,240

111
N001
11111
