NO ./textures/Wall.xpm
SO ./textures/Wall.xpm
WE ./textures/Wall.xpm
EA ./textures/Wall.xpm

F 0,0,0
C 100,100,100

111111
1N   1
111 11
